44444444444444444444
4mm00020088000000334
4m000000000000000034
40020000000020000004
40000000000000000004
400000000mm000000004
400000000mm000000004
40000000002000000004
40000000000000020004
430000000000000000m4
43301000077000000mm4
44444444444444444444
