44444444444444444444
40002002000200200204
40000000000000000004
40000000000000000004
48008008000800800804
4b00b00b000b00b00b04
40000000000000000004
400b00b00bb00b00b004
40000000000000000004
40000000000000000004
40000100053600000004
44444444444444444444
