bbbbbbbb3333bbbbbbbb
b00020000S000020000b
b000000000000000000b
b000002002002000000b
b||||||||||||||||||b
b000000000000000000b
b002000000000002000b
b004444000000444400b
b004224010000422400b
b00--------------00b
bs0000000000000000sb
eeeeeeeeeeeeeeeeeeee
