48444444444444444484
42620000000000000004
40444444444444444404
4040000s0X0000488404
4|4s0000000000400005
404000000000004004-4
40400000000000400404
4041000s030S00400404
40444444444444444405
60-0000000x000000005
60-0000000x000000005
47744444444444444444
