48444444444444444484
40000620000000000004
42005600644444444604
4|444f47444474488604
404s000s4X0000400005
404000000000004004-4
40400000000000400404
4041000s430S00400404
40444444444444444405
40-0000000x000000005
60-0000000x000000005
44444444444444444444
