44444444444444444444
40000000000000000004
40300000000000001004
4000000000000000000b
4000000000000000000b
4000200000000000000b
40000000000000000004
40000000000000000004
40000000000000000004
40000000000000000004
40000000000000000004
44444444444444444444
