44444444444444444444
4b0000000000000000b4
40222000b00b000hhh04
400000b000000b000004
40000000033000000004
b00000003ff30000000b
b00000003ff30000000b
40000000033000000004
400000b000000b000004
40000000b00b00000004
4b0000100000000000b4
44444444444444444444
