44444444444444444444
40000000000000000034
40000000000000000004
40000000000000000004
42000000000001000004
42220000000000000004
42222200000000000004
42222222000000000004
42222222220000000004
42222222222200000004
42222222222222000004
44444444444444444444
