44444444444444444444
40000000040000000004
40000000040000000004
4000X000040000000004
40000000040000000004
40000000040000000004
40000000040000000004
40000000040000000004
40000000040000120004
40000000040000000004
40003000040000xx0004
44444444444444444444
