44444444444444444444
40000200000000004034
40000000000000014004
40044440044444004004
40043040040000004004
40040040042000204004
40240040040040004004
40040240040040004204
40040044440044444004
40040000000000000004
43040000000000000004
44444444444444444444
