00000444444444400000
00004400088000440000
00040040022004004000
00400004400440000400
04f00000000000000f40
4000b0000000000b0004
40000004000040000004
04000000400400000040
004700b004400b007400
00040000000000004000
00004000100000040000
00000444433444400000
