44444444444444444444
40000000000000000004
40000000000000000004
40000000000000000004
40000000000000000004
40000000000000000004
40000000000000000004
40002222222222220004
44402222222222220444
40000000000000000004
43000000010000000034
44444444444444444444
