44444444444444444444
40000000000004000004
40300000000040000004
40000000200400002004
40040020004000000004
40400000040020000004
44000000400000000004
40020004000000040004
40000000020000400004
40000000000004000004
40000000000040002014
44444444444444444444
