44444444444444444444
43---2-0-2---0000004
4S0-00-0-0-000000004
400-00-|-0---00x0004
400-00|0|0-000000004
400-00-0|0---0000004
40000--|2--02-0---04
40000-000--00-0-2-04
40000--|0-0-0-0-0-04
40000-000-00--0-0-04
40X00---0-00--0--014
44444444444444444444
