44444444444444444444
40000000000000000004
40000000000000000004
40000000003000000004
40000000000000200004
40000000000002020004
40000000000000200004
40000000000002020004
40000000010000000004
40000000000000000004
47777777777777777774
44444444444444444444
