04444444444444444440
040g000000000000g040
04000000000000000040
040000000f0000000040
04002000020000020040
04000000000000000040
04f00000000000000f40
04000002000000000240
04000000000000000040
44000000000000000044
30000000010000000003
4mmmmmmmmmmmmmmmmmm4
