44444444444444444444
40002000040240y04204
4100000004||f000f||4
44444400040000000004
4x000000040000X00004
4444444--40000000004
40880Y00004444444444
40200000004Z00004334
40000000004000004004
40000000004004000005
4s020z000S6004000004
44774444444444444444
