48888888888888888884
402020202020202000S4
4|||||||||||||||0004
4|||||||||||||||0004
42020202020202020004
47777777777777771034
48888888888888880004
42020202020202020004
4---------------0004
4---------------0004
402020202020202000s4
47777777777777777774
