44444444444444444444
40002040000004200004
40000042000004000004
40000000000000000004
40000000010000000004
400mmmmmmmmmmmmmm004
60000400033000400005
60000400033000400005
60000000000000000005
40000000044000000004
40000000044000000004
44444444444444444444
