44444444444444444444
40000000000000000034
42000000000000000004
42220000000000000004
42222200000001000004
42222222000000000004
42222222220000000004
42222222222200000004
42222222222222000004
42222222222222220004
42222222222222222204
44444444444444444444
