4eeeeeeeeeeeeeeeeee4
46g00006000000000004
46000000000000000004
44448444444444480004
48800808808080800004
40080070080807000004
40000080000008000004
40000000000000000004
40000000000000000004
41000000000000000004
44000000000000000004
4eeeeeeeeeeeeeeeeee4
