44444444444444333334
4s40000000000e008004
404x000000000e000004
4044444450000e800084
4002000000000e000004
4444444500000e000004
4002000000000e000004
4444444450000e|||||4
4002000000000e000004
4444444445000e000004
4002000000001e00X004
44444444444444444444
