44444433343334444444
400200000200S0002004
40000X00000000y00004
4||||||||||||||||||4
4000000-----00000004
4000000-0s0-00000004
4000000-h0h-00000004
4000000-----00000004
400000000Y0000000004
40000000000000000004
400100000x0000000004
44444444444444444444
