44444444444444444444
m0000000m00000000003
m0200000m00000000003
m000m000m00000000003
m000m000m00000000003
m000m000m|||||444444
ms00m000000000000004
m000m000000000000004
m000m000m00000f00004
m000m000m00000000004
m010m000ms0000000004
44444444444444444444
