44444444444444444444
43000000000000400004
40000000000000400004
40000000002020420004
40020200000000400004
40002020000000400204
44444002040000000004
40000000240200002004
40000000040002000024
40200000040000000004
42000000040000000014
44444444444444444444
