44444444444444444444
43000003420000020004
40000000402000202004
40003000400202000204
40004000400020000024
40034300400000000004
40004000400000000004
40004000400000000004
43004003400000000004
40004000000000000004
41004000000000000004
44444444477777777774
