44444444333344444444
4s0000Y400004X0000S4
40000004000040000004
40200204000040200204
40000004000040000004
40000004000040000004
40000004x00y40000004
4||||||400004------4
40000000000000000004
4b0000000100000000b4
04b00000000000000b40
00444444bbbb44444400
