44444444444444444444
40000000000000000004
40300000030000000304
40000000000000000004
40002000000000200004
40000200010002000004
40000020000020000004
40000000000000000004
40000000000000000004
40300000030000000304
40000000000000000004
44444444444444444444
