44444444444444444444
40000000000000000004
40300000000000001004
40000000000000000004
40000000000000000004
40002000000000000004
40000000000000000004
40000000000000000004
40000000000000000004
40000000000000000004
40000000000000000004
44444444444444444444
