44444444444444444444
40000000000000000004
40000000000000000004
40000000000000000004
40000000001000000004
40000000000000000004
43000000000000000034
43000000000000000034
4300hhhhhhhhhhhh0034
40000000000000000004
477f77f777777f77f774
44444444444444444444
