00eeee00e33e00eeee00
00e10e00e0se00e22e00
00e00e00e00e00e00e00
00e00e00e00e00e00e00
00e00eeee00e00e00e00
00e00000000e00e00e00
00e00000000e00e||e00
00e||eeee--e00e00e00
00e00e00e00e00e--e00
00e00e00e00e00e00e00
00eS0e00e00e00e00e00
00eeee00e33e00eeee00
