bbbbbbbbbbbbbbbbbbbb
b000000000000000000b
b00000000000000000bb
bb00bbbbb00bbbbb000b
b000bf00000000fb000b
b000b0000330000bb00b
b00bb0000330000b000b
b000bf00000000fb000b
b000bbbbbbbbbbbb00bb
bb0000h00000h000000b
b000000001000000000b
bbbbbbbbbbbbbbbbbbbb
