44444444444444444444
40000000000000000004
40030000000000000004
40000000500000000004
40000000000000002004
40000000000000020004
40000000000002000004
40000000000000000004
40000000000000000004
40000100000000000004
40000000000000000004
44444444444444444444
