4mmm44444mmm4444mmm4
40300000003000000304
400000000m0000000004
400m000000000000m004
40002000000000020004
4000000m0020m0000004
40020000000000002004
40000000000000000004
4000m00000m0000m0004
40002000000000020004
40100000000000000004
44444444444444444444
