44444444444444444444
40000000000000000004
40000044400444000004
40000040000004000004
40000040000004000004
40000000030000000004
40202000000000020204
40000040000004000004
40000044401444000004
40000000000000000004
40000000000000000004
44444444444444444444
