00000000000000000000
44444444444444444444
30100000000000000003
30000000000000000203
3xxxxxxxxxxxxxxxx4x3
300000000000000000X3
30002000000000000003
3yyy4yyyyyyyyyyyyyy3
3Y000000000000000003
30000000002000000003
44444444444444444444
00000000000000000000
