44444444444f44444f44
402002002X0e00000e03
400000000000000000s3
400000000z0000e00003
4444----444444f44444
40000000000000000004
40000000010000000x04
444444444444||||4444
402002000Z0000000005
400000000000000000S4
40000000000000000005
44444444444444444444
