44444444444444444444
6200-x000000000004X4
6000-x00000000200404
6|||-x00000000400404
6000-300000020000404
6000-300000040000404
6000-300000000000404
6000-300000000000404
6|||-301000000000404
6000-30b030s030S0404
6000-300030003000404
4xxx4444444444444444
