44444444444444444444
43000000000000000034
40000000000000000004
40000000010000000004
40000000000000000004
40000000000000000004
40002200002200002204
40020020020020020004
40200002200002200004
40000000000000000004
43000000000000000034
44444444444444444444
