44444444444444444444
43000000000000000034
40020000020000020004
40040020040020040004
40000040000040000004
40000000000000000004
40020000020000020004
40040020040020040004
40000040000040000004
40000000000000000004
43000000010000000034
44444444444444444444
