43333333333333333334
40000000bXYb00000004
400bbb00bbbb00bbb004
400h00000hh00000h004
40000000000000000004
4000h00h0000h00h0004
40004004000040040004
40000000000000000004
40000000010000000004
400b00b00bb00b00b004
4xxxxxxxxxyyyyyyyyy4
44444444444444444444
