44444444444444444444
40000000000000000004
40000000000000000004
40000000000000000004
40000000000000000004
40000000000000000004
40000300000000000004
40000000000000000004
40000100000000000004
400000000h0h0h000004
40000000000000000004
44444444444444444444
