000000bbbbbbbbbb0000
0000bb0000000000bb00
000b00000000000000b0
00b00000bbbbbb00000b
0bs000bb020002bb000b
0b0000b0000f0000b00b
30b000|000000000b00b
300b00|0000000bb000b
3000bbbbbbbbbb00000b
300000000000000000b0
0b00001000000000bb00
00bbbbbbbbbbbbbb0000
