44444444444444444444
40000000000000000004
40000000000000000004
40000000000000000004
40000000000000000004
40000000h00000000004
40000000000000000004
40000000000000000004
40000000100000000004
40000000000000000004
43333333333333333334
44444444444444444444
