44444444444444444444
43000000000000000005
44444444444444444004
400000f000s400000004
40000000000400000004
40030030030400444444
4Y000000000|00000004
444444444444000002X4
40000000000444444444
4y0020000000000000x5
40000000000000010005
44444444444444444444
