44444444444444444444
40000000000020000004
40000100000000000004
44400444444444400444
400004Y0000000400004
402004000000304000y4
40000400000000400004
400004X0000000400004
44004444mmmmmm440044
40000000000000000004
40000000000000x00004
44444444444444444444
