44444444444444444444
40004000000000000004
40004000000000000004
40004000000000004444
40000020444444000004
40000000000000000004
40000020010000000004
40000000000000004004
44000020000000004004
40000000000000004004
43000000000000004004
44444444444444444444
