44444444444444444444
43434340000004343434
40404040010004040404
40404040000004040404
40404042222224040404
40404042222224040404
40404040000004040404
40404040000004040404
40404042222224040404
40000000000000000004
40000002222220000004
44444444444444444444
