44444444444444444444
400020000bb000000004
400000000bb200000004
400000002bb000020004
400x00000bb00000X004
430m00200bb00000m034
400Y00000bb00000y004
400000000bb002000004
400000000bb000000004
400000000bb000000004
400000001bb000000004
44444444444444444444
