44444444444444444444
40000000000000002204
43002222000000000004
44444444444444400004
40220000000000000004
40000000000022220034
40000444444444444444
40000000000000002204
43002222000000000004
44444444444444000004
40000000010000220034
44444444444444444444
