43444444444444444444
424S0446600000000004
4|400430000000000004
40400444044444002224
404004460-0|34004444
404004460-s|34000004
404004460-0|34000004
40400444444444002224
40400000000000004444
40400030000000000015
40400000000000000005
4b444444444444444444
