44444444444444444444
40hhhhhhhhhhhhhhhhh4
4||||||||||||||||||4
40000000000000000004
400000000s0000000004
40000000000000000004
40000000000000000004
40010000000000000004
40000000000000000004
40000000000000000004
43333333333333333334
44444444444444444444
