44444444444444444444
43004000020000040034
40004002000200040004
40004000000000040004
43004205000060240034
4|||4s00000000S4---4
60000070000007000005
60000000000000000005
60000000010000000005
60000000070000000005
40000000000000000004
47777777777777777774
