44444444444444444444
40400000000000000005
40444444444444444404
40000033333333340404
4k4000300000003404-4
41400S33300s00340005
40400000000000340005
4040000000000034-404
40433333333333343404
404444444444444444|4
60000000000000000004
44444444444444444474
