44444444444444444444
4X20400020Z2000402Y4
40004400000000440004
40000400000000400004
44420000444400002444
44400000000000000444
40y00440000004400y04
40400040x44004000404
44440040044004004444
4z000000000000000034
4z000000010000000034
44444444444444444444
