44444444444444444444
40000000000000000004
40000000000000000004
40001000hh0000000004
40000000000000000004
40000000220000000004
40000000000000000004
40000000hh0000000004
40000000440000000004
40000000440000000004
40003000440000030004
44444444444444444444
