44444444444444444444
40000000000000000004
40000200000000000004
40300400003030000004
40300000003030000004
40330003303030333004
40303030303030003004
40303030303030030004
40330003303030333004
40000000000000000004
40000000000000000014
44444444444444444444
