44444444444000000000
43|00000000400000u00
43|0100000004000ugu0
4444444000|||4000u00
0000040000|0s0400000
000042000ff000240000
000040200ff002040000
0000040200-000400000
00u0004020---4444444
0ugu00040000000000S4
00u00000400000000004
00000000044444444444
