44444444444444444444
40000000000000000004
40000000000000eeee04
40000000000000e0ge04
40eeeeeeeeeeeee00e04
40e00000000000000e04
40e10000000000000e04
40e00eeeeeeeeeeeee04
40e00e00000000000004
40eeee00000000000004
40000000000000000004
44444444444444444444
