44444444444444444444
40020000000000002004
40000000000000000004
42770007777770007724
40000200000000200004
40000000000000000004
40000000hhhh00000004
47777774----47777774
400000040S0040000004
40000000000000000004
40010000000000000004
44444444333344444444
