48888444444444444444
30000000000000000b0e
30000010002020200h0e
e000000000000000000e
e0000000000000000b0e
e0000000554444444444
e0000000554444444444
e0000000000000000b0e
e0000000002020200h0e
3000000000000000000e
30000000000000000b0e
47777444444444444444
