00000000000000000000
00004444000000000000
00004334444444440000
00004000000000040000
00004000220000350000
00004004444444440000
00004004000000000000
00004104000000000000
00004004000000000000
00004334000000000000
00004444000000000000
00000000000000000000
