44444444444444444444
40000000000000000004
40000f00000000f00004
40030000000000003004
40000000000000000004
4003000f2002f0003004
40000002000020000004
400f002000000200f004
4000020f000f00200004
40002000000000020004
40000000010000000004
44444444444444444444
