4b3b3b3b3b3b3b444444
40000000000000|00s04
400000S0000000|00004
40000000000000|00004
40000000000000|00004
40404040404040400004
40404040404040400004
4|7|7|7|7|7|7|400004
40404040404040400004
4-4-4-4-4-4-4-400004
42424242424242400104
47777777777777744444
