bbbbbbbbbbbbbbbbbbbb
3S0000000000000000s3
30002000010000020003
300y00000Z000000x003
30000000000000000003
bbbbbbbbbbbbbbbbbbbb
300000b000000b000003
300000-00z000|000003
300020-000000|020003
30Y000-000020|000X03
300000b000000b000003
77777777777777777777
