43334444444444444444
40006000000000000004
401060S0000000000004
400060000000000e0004
40004eeeeeeeeeee0004
400000000000000e0004
40000000000000000004
40s00000000000000004
444444------44444444
62000|000000x6X00004
60200|000000x6X00004
4bbbb477777744444444
