44444444444444444444
43333333333333333334
40000000000000000004
42222222000022222224
44444444000044444444
40000000000000000004
40000000000000001004
40000000000000000004
40000000000000000004
40000000000000000004
43333333333333333334
44444444444444444444
