44444444444444444444
40000000000400000004
40000000000400100004
40030000000400000004
40000000000400000004
40000000000400000004
40000000000400000004
40000000X004x00000x4
400000000004x02220x4
400000000004x00000x4
400000000004x02220x4
44444444444444444444
