44444444444444444444
40000000000000000004
40008844000000000004
40000034000000000004
40000044000000000004
40000000000000000004
40000000000000000004
40000000000000000004
40000000000000000004
40000100000000000004
40000000000000022004
44444444444444444444
