44444444444444444444
40s00000000000000004
40000000000000000004
44444000000000040004
400044||444444440004
40000000000000540004
400000000000x0540004
44444844854844440004
40000200200200340204
40X00000000000340004
40000000000000340104
44444744744744444444
