44444444444444444444
40000000000000000004
40000000030000000004
40000000000000000004
40000000000000000004
40000000000000000004
40000000000000000004
40000020000002000004
40000000040000000004
40000000040000000004
41000000040000000004
44444444444444444444
