44444444444444444444
44000020004088888804
4040000004000s330004
40040000400000000004
40204004000000880004
40000||0000000000004
40000||0000000000004
40004004000000000004
40040200400000000004
40400000040000000004
44000000004000100004
44444444444444444444
